12 13
G.X...T...X.G
....XXXXX....
.XX.......XX.
....X...X....
............K
.XXXX...XXXX.
.............
....X...X....
.XX.X...X.XX.
.............
....XXXXX....
..X...S...X..
